𑐀𑐄𑐮 | अउल | əulə | (aula) | Noun | 1. malaria
𑐀𑑄𑐐𑑅 | अंगः | ə̃ːɡəː | (aṃga:) | Noun | 1. wall
𑐀𑑄𑐐𑑂𑐬𑐾𑐖𑐷 | अंग्रेजी | ə̃ːɡɾed͡ʑiː | (aṃgrejī) | Adjective | 1. English (language)
𑐀𑐖𑐶 | अजि | əd͡ʑi | (aji) | Noun | 1. paternal_grandmother
𑐀𑐥𑐵 | अपा | əpa | (apā) | Noun | 1. brick
𑐀𑐧𑐸 | अबु | əbu | (abu) | Noun | 1. father
𑐀𑐩𑑂𑐥𑐶 | अम्पि | əmpi | (ampi) | Noun | 1. spleen
𑐀𑐫𑑂 | अय् | ɛː | (ê) | _ | 1. Used to represent the [ɛː] sound in Newar
𑐀𑐫𑑂‌𑐮𑐵𑑅 | अय्‌लाः | ɛːlaː | (êlā:) | Noun | 1. alcohol, distilled beverage
𑐀𑐮𑑅𑐩𑐵 | अलःमा | ələːma | (ala:mā) | Noun | 1. castor_oil_plant
𑐀𑐮𑑂𑐫𑐵𑐏 | अल्याख | əljakʰə | (alyākha) | Noun | 1. (mathematics) infinity
𑐁𑐣𑑂𑐢𑑂𑐬𑐥𑑂𑐬𑐡𑐾𑐱 | आन्ध्रप्रदेश | andʱɾə pɾədes | (āndhrapradeśa) | Noun | 1. Andhra_Pradesh
𑐁𑐩𑑂𑐥𑐵𑑄 | आम्पां | ampãː | (āmpāṃ) | Noun | 1. anus
𑐁𑐫𑑂 | आय् | æː | (æ) | _ | 1. Used to represent the [æː] sound in Newar
𑐁𑐮𑐸𑐥𑐴𑑅 | आलुपहः | alupəhəː | (ālupaha:) | Noun | 1. (physics) plasticity
𑐂𑐏𑐸𑑄 | इखुं | ikʰũː | (ikhuṃ) | Noun | 1. swallow
𑐂𑐩𑐵 | इमा | ima | (imā) | Pronoun | 1. Devanagari_script form of imā (“this one”)
𑐂𑐩𑐹 | इमू | imuː | (imū) | Noun | 1. ant
𑐂𑐳𑐶 | इसि | isi | (isi) | Noun | 1. Devanagari_script form of isi (“sage, seer”)
𑐂𑐴𑐶𑐥𑐵 | इहिपा | ihipa | (ihipā) | Noun | 1. marriage
𑐃𑑄 | ईं | ĩː | (īṃ) | Noun | 1. sickle
𑐃𑐮𑐔𑑄 | ईलचं | iːlət͡ɕə̃ː | (īlacaṃ) | Noun | 1. clock
𑐄𑐳𑐵𑑃𑐫𑑂‌ | उसाँय्‌ | usæ̃ː | (usæ̃) | Noun | 1. health
𑐊𑐫𑑂 | एय् | eɛː | (eê) | _ | 1. Used to represent the [eɛː] sound in Newar
𑐎𑐟𑐵𑑃𑐩𑐬𑐷 | कताँमरी | kətãməɾiː | (katā̃marī) | Noun | 1. doll
𑐎𑐠𑐸 | कथु | kətʰu | (kathu) | Noun | 1. neck
𑐎𑑅𑐣𑐶 | कःनि | kəːni | (ka:ni) | Noun | 1. maize
𑐎𑑃𑐫𑑂 | कँय् | kɛ̃ː | (kễ) | Noun | 1. bronze
𑐎𑐫𑑂‌𑐩𑐶 | कय्‌मि | kɛːmi | (kêmi) | Noun | 1. magpie
𑐎𑐮𑐵𑑅 | कलाः | kəlaː | (kalā:) | Noun | 1. wife
𑐎𑐮𑑂𑐎𑐶𑐗𑑄𑐐𑑅 | कल्किझंगः | kəlkid͡ʑʱə̃ːɡəː | (kalkijhaṃga:) | Noun | 1. drongo
𑐎𑐰𑑄 | कवं | kəwɔ̃ː | (kawaṃ) | Noun | 1. skeleton
𑐎𑐳𑑂𑐟𑐶 | कस्ति | kəsti | (kasti) | Noun | 1. honey
𑐎𑐳𑑂𑐟𑐶𑐴𑐵 | कस्तिहा | kəstiha | (kastihā) | Noun | 1. honeybee
𑐎𑐵𑐥𑑅 | कापः | kapəː | (kāpa:) | Noun | 1. textile
𑐎𑐵𑐳𑐵 | कासा | kasa | (kāsā) | Noun | 1. sport, game
𑐎𑐶𑑄 | किं | kĩː | (kiṃ) | Pronoun | 1. Devanagari_script form of kiṃ, which is nominative/accusative singular of
𑐎𑐶𑐔𑑅 | किचः | kit͡ɕəː | (kica:) | Noun | 1. shadow
𑐎𑐶𑐥𑐹 | किपू | kipuː | (kipū) | _ | 1. Kirtipur
𑐎𑐶𑐳𑐶 | किसि | kisi | (kisi) | Noun | 1. elephant
𑐎𑐸𑑃 | कुँ | kũ | (kũ) | Noun | 1. smoke
𑐎𑐸𑑄 | कुं | kũː | (kuṃ) | Noun | 1. (geometry) angle
𑐎𑐸𑑃𑐂𑑃 | कुँइँ | kũĩ | (kũĩ) | Noun | 1. knife
𑐎𑐸𑐔𑐵𑐏𑐵𑐥𑐵 | कुचाखापा | kut͡ɕakʰapa | (kucākhāpā) | Noun | 1. Dutch_door
𑐎𑐸𑐮𑐵𑑄𑐗𑑄𑐐𑑅 | कुलांझंगः | kulãːd͡ʑʱə̃ːɡəː | (kulāṃjhaṃga:) | Noun | 1. cuckoo
𑐎𑐾𑐧 | केब | kebə | (keba) | Noun | 1. garden
𑐎𑑂𑐰𑑅 | क्वः | kwɔː | (kwa:) | Noun | 1. crow
𑐎𑑂𑐰𑐏𑑅_𑐑𑐵𑑃𑐫𑑂 | क्वखः घाँय् | kwɔkʰəː ɡʱæ̃ː | (kwakha: ghæ̃) | Noun | 1. Bermuda_grass
𑐎𑑂𑐰𑐟𑑅 | क्वतः | kwɔtəː | (kwata:) | Noun | 1. skull
𑐎𑑂𑐰𑐥𑐸𑐗𑑂𑐫𑐵𑑅 | क्वपुझ्याः | kwɔpud͡ʑʱjaː | (kwapujhyā:) | Noun | 1. dormer-window
𑐎𑑂𑐰𑐧𑑂𑐰𑐵𑑅𑐮𑑅 | क्वब्वाःलः | kwɔbwaːləː | (kwabwā:la:) | Noun | 1. waterfall
𑐎𑑂𑐰𑑃𑐫𑑂 | क्वँय् | kwɔ̃ɛː | (kwãê) | Noun | 1. bone
𑐎𑑂𑐰𑑃𑐮𑑅𑐏𑐵 | क्वँलःखा | kwɔ̃ləːkʰa | (kwãla:khā) | Noun | 1. crane
𑐎𑑂𑐰𑐵𑐳𑐶 | क्वासि | kwasi | (kwāsi) | Noun | 1. penis
𑐏𑑃𑐐𑑂𑐰𑑅 | खँग्वः | kʰə̃ɡwɔː | (khãgwa:) | Noun | 1. word
𑐏𑑃𑐐𑑂𑐰𑑅𑐳𑐦𑐹 | खँग्वःसफू | kʰə̃ɡwɔːsəpʰuː | (khãgwa:saphū) | Noun | 1. dictionary
𑐏𑑃𑐟𑑂𑐰𑐵 | खँत्वा | kʰə̃twa | (khãtwā) | Noun | 1. phrase
𑐏𑐵𑐏𑐶𑐥𑑅 | खाखिपः | kʰakʰipəː | (khākhipa:) | Noun | 1. plumb_bob
𑐏𑐶 | खि | kʰi | (khi) | Noun | 1. feces
𑐏𑐶𑐔𑐵 | खिचा | kʰit͡ɕa | (khicā) | Noun | 1. dog
𑐏𑐶𑐥𑑅 | खिपः | kʰipəː | (khipa:) | Noun | 1. rope
𑐏𑐸𑐎𑐸𑑄 | खुकुं | kʰukũː | (khukuṃ) | Noun | 1. hexagon
𑐏𑐸𑐳𑐶 | खुसि | kʰusi | (khusi) | Noun | 1. river
𑐏𑑂𑐫𑐸𑑄 | ख्युं | kʰjũː | (khyuṃ) | Noun | 1. darkness
𑐏𑑂𑐰𑐧𑐶 | ख्वबि | kʰwɔbi | (khwabi) | Noun | 1. tear (from one's eyes)
𑐏𑑂𑐰𑐮𑑂𑐔𑐵𑐑𑐵𑑃𑐫𑑂 | ख्वल्चाघाँय् | kʰwɔlt͡ɕaɡʱæ̃ː | (khwalcāghæ̃) | Noun | 1. false_daisy (Eclipta_prostrata)
𑐏𑑂𑐰𑐵𑑅 | ख्वाः | kʰwaː | (khwā:) | Noun | 1. face
𑐐𑑅𑐥𑑅 | गःपः | ɡəːpəː | (ga:pa:) | Noun | 1. neck
𑐐𑐮𑑂𑐕𑐶 | गल्छि | ɡəlt͡ɕʰi | (galchi) | Noun | 1. canyon
𑐐𑐮𑑂𑐮𑐶𑐕𑐶 | गल्लिछि | ɡəllit͡ɕʰi | (gallichi) | Noun | 1. stream
𑐐𑑄𑐮𑑂𑐰𑐫𑑂 | गंल्वय् | ɡə̃ːlwɔɛː | (gaṃlwaê) | Noun | 1. tuberculosis
𑐐𑐳𑐵 | गसा | ɡəsa | (gasā) | Noun | 1. vehicle
𑐐𑐳𑐸 | गसु | ɡəsu | (gasu) | Noun | 1. etiquette
𑐐𑐵𑐮𑐶 | गालि | ɡali | (gāli) | Noun | 1. fan (electrical or handheld)
𑐐𑐶𑐳𑐵 | गिसा | ɡisa | (gisā) | Noun | 1. scriber
𑐐𑐸𑑄 | गुं | ɡũː | (guṃ) | Noun | 1. forest
𑐐𑐸𑑃𑐖𑐮𑐵 | गुँजला | ɡũd͡ʑəla | (gũjalā) | Noun | 1. volcano
𑐐𑐸𑐣𑐎𑐾𑐬𑐵 | गुनकेरा | ɡunəkeɾa | (gunakerā) | Noun | 1. daffodil
𑐐𑐾𑑃𑐳𑐸 | गेँसु | ɡẽsu | (gẽsu) | Noun | 1. gravity
𑐐𑑂𑐫𑐵𑐣𑐵 | ग्याना | ɡjana | (gyānā) | Noun | 1. fear
𑐐𑑂𑐫𑐵𑐫𑐾 | ग्याये | ɡjaje | (gyāye) | Verb | 1. to fear
𑐐𑑂𑐰𑐵𑐮𑐶 | ग्वालि | ɡwali | (gwāli) | Noun | 1. heel
𑐑𑑅𑐔𑐵 | घःचा | ɡʱəːt͡ɕa | (gha:cā) | Noun | 1. wheel
𑐔𑐵𑐎𑐸𑐴𑐶 | चाकुहि | t͡ɕakuhi | (cākuhi) | Noun | 1. sweet_potato
𑐔𑐵𑑅𑐟𑐶 | चाःति | t͡ɕaːti | (cā:ti) | Noun | 1. sweat
𑐔𑐵𑐳𑐸 | चासु | t͡ɕasu | (cāsu) | Adjective | 1. itchy
𑐔𑐵𑐴𑐶𑐮𑐶𑐐𑐸 | चाहिलिगु | t͡ɕahiliɡu | (cāhiligu) | Noun | 1. travel
𑐔𑐶𑐎𑑄 | चिकं | t͡ɕikə̃ː | (cikaṃ) | Noun | 1. oil
𑐔𑐶𑐎𑑄𑐳𑐶 | चिकंसि | t͡ɕikə̃ːsi | (cikaṃsi) | Noun | 1. lychee
𑐔𑐶𑐎𑐸𑐮𑐵 | चिकुला | t͡ɕikula | (cikulā) | Noun | 1. hemanta ('pre-winter')
𑐔𑐸𑐳𑐶 | चुसि | t͡ɕusi | (cusi) | Noun | 1. knife
𑐔𑑂𑐫𑐵𑐎𑐸𑑄 | च्याकुं | t͡ɕjakũː | (cyākuṃ) | Noun | 1. octagon
𑐔𑑂𑐰𑐏𑑃 | च्वखँ | t͡ɕwɔkʰə̃ | (cwakhã) | Noun | 1. essay
𑐔𑑂𑐰𑐫𑐾 | च्वये | t͡ɕwɔje | (cwaye) | Noun | 1. book
𑐔𑑂𑐰𑐮𑑂𑐰𑐴𑑄 | च्वल्वहं | t͡ɕwɔlwɔhə̃ː | (cwalwahaṃ) | Noun | 1. flint, flintstone
𑐔𑑂𑐰𑐵𑐥𑐸𑐏𑐸 | च्वापुखु | t͡ɕwapukʰu | (cwāpukhu) | Noun | 1. glacier
𑐔𑑂𑐰𑐵𑐥𑐸𑐐𑐸𑑄 | च्वापुगुं | t͡ɕwapuɡũː | (cwāpuguṃ) | Noun | 1. mountain
𑐔𑑂𑐰𑐵𑐥𑐸𑐴𑐸𑐬 | च्वापुहुर | t͡ɕwapuhuɾə | (cwāpuhura) | Noun | 1. avalanche
𑐔𑑂𑐰𑐵𑐩𑑂𑐰𑑅𑐳𑐵 | च्वाम्वःसा | t͡ɕwamwɔːsa | (cwāmwa:sā) | Noun | 1. yak
𑐔𑑂𑐰𑐾𑐐𑐸 | च्वेगु | t͡ɕweɡu | (cwegu) | Noun | 1. writing
𑐕𑐶𑐐𑐸 | छिगु | t͡ɕʰiɡu | (chigu) | Pronoun | 1. your, yours
𑐕𑐾𑑃 | छेँ | t͡ɕʰẽ | (chẽ) | Noun | 1. house
𑐕𑐾𑑄𑐐𑐹 | छेंगू | t͡ɕʰẽɡuː | (cheṃgū) | Noun | o The Bible Psalms.102.5:
𑐕𑑂𑐫𑑄 | छ्यं | t͡ɕʰjə̃ː | (chyaṃ) | Noun | 1. head
𑐖𑑅 | जः | d͡ʑəː | (ja:) | Noun | 1. light
𑐖𑐮𑐵𑐳𑐾𑑄 | जलासें | d͡ʑəlasẽ | (jalāseṃ) | Noun | 1. kidney
𑐖𑐰𑐵𑑅𑐖𑑂𑐫𑐵 | जवाःज्या | d͡ʑəwaːd͡ʑja | (jawā:jyā) | Noun | 1. animal_husbandry
𑐖𑐵𑐎𑐶 | जाकि | d͡ʑaki | (jāki) | Noun | 1. rice
𑐖𑐶𑐮𑑄𑐖𑑂𑐫𑐵 | जिलंज्या | d͡ʑilə̃ːd͡ʑja | (jilaṃjyā) | Noun | 1. digestion
𑐖𑐷𑐳𑑂𑐰𑐵𑑄 | जीस्वां | d͡ʑiːswãː | (jīswāṃ) | Noun | 1. jasmine flower
𑐖𑐸𑐖𑐸 | जुजु | d͡ʑud͡ʑu | (juju) | Noun | 1. king, monarch
𑐖𑐸𑐫𑐾 | जुये | d͡ʑuje | (juye) | Verb | 1. to become
𑐗𑑄𑐐𑑅 | झंगः | d͡ʑʱə̃ːɡəː | (jhaṃga:) | Noun | 1. bird
𑐗𑐵𑐳𑐸 | झासु | d͡ʑʱasu | (jhāsu) | Noun | 1. leisure
𑐗𑐶𑐐𑐸 | झिगु | d͡ʑʱiɡu | (jhigu) | Pronoun | 1. my, mine
𑐗𑑂𑐫𑐵𑑅 | झ्याः | d͡ʑʱjaː | (jhyā:) | Noun | 1. window
𑐗𑑂𑐰𑐮𑐗𑑄𑐐𑑅 | झ्वलझंगः | d͡ʑʱwɔləd͡ʑʱə̃ːɡəː | (jhwalajhaṃga:) | Noun | 1. owl
𑐗𑑂𑐰𑐵𑐮𑐵 | झ्वाला | d͡ʑʱwala | (jhwālā) | Noun | 1. waterfall
𑐗𑑂𑐰𑐵𑐳𑑂𑐫𑐵 | झ्वास्या | d͡ʑʱwasja | (jhwāsyā) | Noun | 1. swamp
𑐜𑑂𑐰𑐵𑐎𑐸 | ड्वाकु | ɖwaku | (ḍwāku) | Adjective | 1. big, large, great
𑐟𑑄 | तं | tə̃ː | (taṃ) | Pronoun | 1. Devanagari_script form of taṃ, which is accusative singular of त्वं
𑐟𑐎𑐸𑐳𑑂𑐰𑐵𑑄 | तकुस्वां | təkuswãː | (takuswāṃ) | Noun | 1. rhododendron
𑐟𑐕𑑂𑐰 | तछ्व | tət͡ɕʰwɔ | (tachwa) | Noun | 1. barley
𑐟𑐖𑐶𑐮𑐖𑐶 | तजिलजि | təd͡ʑiləd͡ʑi | (tajilaji) | Noun | 1. culture
𑐟𑐠𑑂𑐫𑐵𑐒𑑂𑐎 | तथ्याङ्क | tətʰjaŋkə | (tathyāṅka) | Noun | 1. statistics
𑐟𑐣𑐾𑐖𑑂𑐫𑐵 | तनेज्या | təned͡ʑja | (tanejyā) | Noun | 1. (mathematics) addition
𑐟𑐥𑐵𑐫𑑂 | तपाय् | təpæː | (tapæ) | Noun | 1. ancestor
𑐟𑑃𑐫𑑂 | तँय् | tɛ̃ː | (tễ) | Noun | 1. wool
𑐟𑑅𑐴𑐵𑑅𑐣𑐐𑐸 | तःहाःनगु | təːhaːnəɡu | (ta:hā:nagu) | Noun | 1. comet
𑐟𑐵 | ता | ta | (tā) | Pronoun | 1. Devanagari_script form of tā (“she”)
𑐟𑐵𑐫𑑂‌𑐐𑑅𑐳𑐶𑐩𑐵 | ताय्‌गःसिमा | tæːɡəːsima | (tæga:simā) | Noun | 1. palm_tree
𑐟𑐵𑐮𑑂𑐮𑐵 | ताल्ला | talla | (tāllā) | Noun | 1. summer
𑐟𑐶 | ति | ti | (ti) | Noun | 1. Devanagari_script form of ti (“thus”)
𑐟𑐶𑑃𑐢𑐸𑑃 | तिँधुँ | tĩdʱũ | (tĩdhũ) | Noun | 1. leopard
𑐟𑐶𑐧𑑅 | तिबः | tibəː | (tiba:) | Noun | 1. force
𑐟𑐶𑐩𑐶𑐮𑐵 | तिमिला | timila | (timilā) | Noun | 2. a moon
𑐟𑐶𑐳𑐵 | तिसा | tisa | (tisā) | Noun | 1. jewellery
𑐟𑐷𑐩𑐵 | तीमा | tiːma | (tīmā) | Noun | 1. (archery) bow
𑐟𑐸𑐎𑑄 | तुकं | tukə̃ː | (tukaṃ) | Noun | 1. mustard plant
𑐟𑐸𑐟𑐶 | तुति | tuti | (tuti) | Noun | 1. leg
𑐟𑐸𑐥𑑅 | तुपः | tupəː | (tupa:) | Noun | 1. gun
𑐟𑐸𑐫𑐸 | तुयु | tuju | (tuyu) | Noun | 1. white
𑐟𑑂𑐰𑑃𑐳𑐵 | त्वँसा | twɔ̃sa | (twãsā) | Noun | 1. drink, beverage
𑐠𑐶𑑃𑐨𑑅 | थिँभः | tʰĩbʱəː | (thĩbha:) | Noun | 1. lever
𑐠𑑂𑐰 | थ्व | tʰwɔ | (thwa) | Pronoun | o The Bible Psalms.102.18:
𑐡𑑃 | दँ | də̃ | (dã) | Noun | 1. year
𑐡𑐠𑐸 | दथु | dətʰu | (dathu) | Noun | 1. center
𑐡𑐣𑐵𑐳𑐸 | दनासु | dənasu | (danāsu) | Noun | 1. consciousness
𑐡𑐧𑐮𑐶 | दबलि | dəbəli | (dabali) | Noun | 1. theatre (structure)
𑐡𑐧𑐹 | दबू | dəbuː | (dabū) | Noun | 1. theatre (structure)
𑐡𑐧𑐹_𑐥𑑂𑐫𑐵𑐏𑑄 | दबू प्याखं | dəbuː pjakʰə̃ː | (dabū pyākhaṃ) | Noun | 1. theatre (art form)
𑐡𑐵𑑅 | दाः | daː | (dā:) | Noun | 1. fat
𑐡𑐸𑐐𑑅𑐎𑑂𑐰𑑃𑐫𑑂 | दुगःक्वँय् | duɡəːkwɔ̃ɛː | (duga:kwãê) | Noun | 1. backbone, vertebral_column
𑐡𑐸𑐐𑐸 | दुगु | duɡu | (dugu) | Noun | 1. goat
𑐡𑐸𑐬𑐸 | दुरु | duɾu | (duru) | Noun | 1. milk
𑐡𑐸𑐬𑐸𑐮𑑂𑐰𑐴𑑄 | दुरुल्वहं | duɾulwɔhə̃ː | (durulwahaṃ) | Noun | 1. marble
𑐡𑐸𑐳𑐶𑐎𑐵 | दुसिका | dusika | (dusikā) | Noun | 1. science
𑐡𑐸𑐳𑐾 | दुसे | duse | (duse) | Noun | 1. millet
𑐡𑑂𑐫𑑅𑐏𑑂𑐫𑐵𑐮𑑅 | द्यःख्यालः | djəːkʰjaləː | (dya:khyāla:) | Noun | 1. atheism
𑐡𑑂𑐰𑐴𑑃 | द्वहँ | dwɔhə̃ | (dwahã) | Noun | 1. bull
𑐢𑐸𑑃 | धुँ | dʱũ | (dhũ) | Noun | 1. tiger
𑐢𑑂𑐫𑐧𑐵 | ध्यबा | dʱjəba | (dhyabā) | Noun | 1. money
𑐢𑑂𑐰𑑅 | ध्वः | dʱwɔː | (dhwa:) | Noun | 1. (geometry) line
𑐢𑑂𑐰𑐵𑐫𑐾𑐖𑑂𑐫𑐵 | ध्वायेज्या | dʱwajed͡ʑja | (dhwāyejyā) | Noun | 1. printing (books, paper, etc.)
𑐣𑑃 | नँ | nə̃ | (nã) | Noun | 1. iron
𑐣𑐎𑐶𑑄 | नकिं | nəkĩː | (nakiṃ) | Noun | 1. nail (fastener)
𑐣𑐏𑑅 | नखः | nəkʰəː | (nakha:) | Noun | 1. festival
𑐣𑐐𑐸 | नगु | nəɡu | (nagu) | Noun | 1. star
𑐣𑐐𑐸𑐩𑐵𑑄 | नगुमां | nəɡumãː | (nagumāṃ) | Noun | 1. calendar
𑐣𑐫𑐾 | नये | nəje | (naye) | Noun | 1. Devanagari_script form of naye, which is locative singular of नय (naya,
𑐣𑐰𑑅𑐑𑐵𑑃𑐫𑑂 | नवःघाँय् | nəwɔːɡʱæ̃ː | (nawa:ghæ̃) | Noun | 1. (botany) mint
𑐣𑐳𑐵𑐟𑑂𑐰𑑃𑐳𑐵 | नसात्वँसा | nəsatwɔ̃sa | (nasātwãsā) | Noun | 1. food
𑐣𑐴𑐵𑑅 | नहाः | nəhaː | (nahā:) | Noun | 1. body armor
𑐣𑐸𑐐𑑅 | नुगः | nuɡəː | (nuga:) | Noun | 1. heart
𑐣𑐸𑐐𑑅𑐡𑑂𑐫𑑅 | नुगःद्यः | nuɡəːdjəː | (nuga:dya:) | Noun | 1. soul
𑐣𑑂𑐫𑐵𑐎𑐸𑑄 | न्याकुं | njakũː | (nyākuṃ) | Noun | 1. pentagon
𑐣𑑂𑐰𑐎𑐹 | न्वकू | nwɔkuː | (nwakū) | Noun | 1. wedge
𑐤𑐵𑐫𑑂 | न्हाय् | nʱæː | (nhæ) | Noun | 1. nose
𑐤𑐶 | न्हि | nʱi | (nhi) | Noun | 1. day, from sunrise to sunset
𑐤𑐶𑐎𑐵𑑄𑐗𑑄𑐐𑑅 | न्हिकांझंगः | nʱikãːd͡ʑʱə̃ːɡəː | (nhikāṃjhaṃga:) | Noun | 1. owl
𑐤𑐸 | न्हु | nʱu | (nhu) | Noun | 1. day, from midnight to midnight
𑐤𑐾𑐎𑐸𑑄 | न्हेकुं | nʱekũː | (nhekuṃ) | Noun | 1. heptagon
𑐤𑐾𑐥𑐸 | न्हेपु | nʱepu | (nhepu) | Noun | 1. brain
𑐤𑑂𑐫𑐧𑑂𑐰𑐳𑐵 | न्ह्यब्वसा | nʱjəbwɔsa | (nhyabwasā) | Noun | 1. toy
𑐤𑑂𑐫𑐵𑐎𑑄 | न्ह्याकं | nʱjakə̃ː | (nhyākaṃ) | Noun | 1. mirror
𑐤𑑂𑐫𑐵𑐥𑑄 | न्ह्यापं | nʱjapə̃ː | (nhyāpaṃ) | Noun | 1. ear
𑐤𑑂𑐫𑐵𑐥𑑄𑐥𑐶𑐮𑐶 | न्ह्यापंपिलि | nʱjapə̃ːpili | (nhyāpaṃpili) | Noun | 1. eardrum
𑐥𑐘𑑂𑐖𑐵𑐧𑐷 | पञ्जाबी | pənd͡ʑabiː | (pañjābī) | _ | 1. Punjabi
𑐥𑐟𑐶𑑄 | पतिं | pətĩː | (patiṃ) | Verb | 1. Devanagari_script form of patiṃ, which is first-person singular aorist
𑐥𑐮𑐾𑐳𑑂𑐰𑐵𑑄 | पलेस्वां | pəleswãː | (paleswāṃ) | Noun | 1. water_lily
𑐥𑐵𑑅 | पाः | paː | (pā:) | Noun | 1. axe
𑐥𑐵𑑅𑐮𑐹𑐐𑐸_𑐳𑐩𑐠𑐬 | पाःलूगु समथर | paːluːɡu səmətʰəɾə | (pā:lūgu samathara) | Noun | 1. inclined_plane
𑐥𑐵𑐴𑐵𑑄 | पाहां | pahãː | (pāhāṃ) | Noun | 1. guest
𑐥𑐸𑐮𑐶 | पुलि | puli | (puli) | Noun | 1. knee
𑐥𑐸𑐮𑐶𑐎𑑂𑐰𑑃𑐫𑑂 | पुलिक्वँय् | pulikwɔ̃ɛː | (pulikwãê) | Noun | 1. kneecap
𑐥𑑂𑐫𑐎𑐸𑑄 | प्यकुं | pjəkũː | (pyakuṃ) | Noun | 1. quadrilateral
𑐥𑑂𑐫𑐵𑐏𑑄 | प्याखं | pjakʰə̃ː | (pyākhaṃ) | Noun | 1. dance
𑐥𑑂𑐬𑐰𑐾𑐐 | प्रवेग | pɾəweɡə | (prawega) | Noun | 1. acceleration
𑐥𑑂𑐰𑐮𑐵𑐏 | प्वलाख | pwɔlakʰə | (pwalākha) | Noun | 1. platinum
𑐦𑐂 | फइ | pʰəi | (phai) | Noun | 1. sheep
𑐦𑐫𑑂 | फय् | pʰɛː | (phê) | Noun | 1. wind
𑐦𑐫𑑂‌𑐏𑑅 | फय्‌खः | pʰɛːkʰəː | (phêkha:) | Noun | 1. airplane
𑐦𑐵 | फा | pʰa | (phā) | Noun | 1. five
𑐦𑐶 | फि | pʰi | (phi) | Noun | 1. sand
𑐦𑐶𑐐𑑅 | फिगः | pʰiɡəː | (phiga:) | Noun | 1. pebble
𑐦𑐶𑐥𑐹 | फिपू | pʰipuː | (phipū) | Noun | 1. mica
𑐦𑐶𑐳𑑅𑐧𑐸𑑃 | फिसःबुँ | pʰisəːbũ | (phisa:bũ) | Noun | 1. desert
𑐦𑐸𑐟𑐶 | फुति | pʰuti | (phuti) | Noun | 1. (geometry) point
𑐧𑐏𑐸𑑄 | बखुं | bəkʰũː | (bakhuṃ) | Noun | 1. pigeon
𑐧𑐣𑐫𑑂‌𑐖𑑂𑐫𑐵 | बनय्‌ज्या | bənɛːd͡ʑja | (banêjyā) | Noun | 1. business
𑐧𑐩𑐹 | बमू | bəmuː | (bamū) | Noun | 1. carnivore
𑐧𑑄𑐩𑐾𑐫𑑂 | बंमेय् | bə̃ːmeɛː | (baṃmeê) | Noun | 1. wild water_buffalo
𑐧𑐮𑐵 | बला | bəla | (balā) | Noun | 1. arrow
𑐧𑑅𑐳𑐶 | बःसि | bəːsi | (ba:si) | Noun | 1. peach
𑐧𑐴𑐣𑐶 | बहनि | bəhəni | (bahani) | Noun | 1. night
𑐧𑑅𑐴𑑃𑐫𑑂 | बःहँय् | bəːhɛ̃ː | (ba:hễ) | Noun | 1. swan
𑐧𑐶𑐡𑐵 | बिदा | bida | (bidā) | Noun | 1. holiday
𑐧𑐸𑐏𑑃𑐥𑑁 | बुखँपौ | bukʰə̃pəu | (bukhãpau) | Noun | 1. newspaper
𑐧𑐸𑑃𑐕𑐸𑑃 | बुँछुँ | bũt͡ɕʰũ | (bũchũ) | Noun | 1. squirrel
𑐧𑐸𑑃𑐖𑑂𑐫𑐵 | बुँज्या | bũd͡ʑja | (bũjyā) | Noun | 1. agriculture
𑐧𑐸𑐮𑐶 | बुलि | buli | (buli) | Noun | 1. cereal (grain)
𑐧𑐸𑐳𑐵 | बुसा | busa | (busā) | Noun | 1. face_powder
𑐧𑐹𑐧𑑅 | बूबः | buːbəː | (būba:) | Noun | 1. legume
𑐧𑐾𑐮𑐵 | बेला | bela | (belā) | Noun | 1. violin
𑐧𑑂𑐫𑐵𑑄𑐔𑐵 | ब्यांचा | bjãːt͡ɕa | (byāṃcā) | Noun | 1. frog
𑐧𑑂𑐫𑐵𑑄𑐥𑐵𑐳𑐶 | ब्यांपासि | bjãːpasi | (byāṃpāsi) | Noun | 1. strawberry
𑐧𑑂𑐰𑐴 | ब्वह | bwɔhə | (bwaha) | Noun | 1. heron
𑐧𑑂𑐰𑐴𑑅 | ब्वहः | bwɔhəː | (bwaha:) | Noun | 1. shoulder
𑐨𑐵𑐫𑑂 | भाय् | bʱæː | (bhæ) | Noun | 1. language
𑐨𑐵𑐫𑑂‌𑐮𑐔𑑄 | भाय्‌लचं | bʱæːlət͡ɕə̃ː | (bhælacaṃ) | Noun | 1. grammar
𑐨𑐸𑐏𑐵 | भुखा | bʱukʰa | (bhukhā) | Noun | 1. earthquake
𑐨𑐸𑐏𑐵𑐔𑐵 | भुखाचा | bʱukʰat͡ɕa | (bhukhācā) | Noun | 1. donkey
𑐨𑐸𑐟𑐹 | भुतू | bʱutuː | (bhutū) | Noun | 1. kitchen
𑐨𑐸𑐫𑐸 | भुयु | bʱuju | (bhuyu) | Noun | 1. gray
𑐨𑐸𑐮𑐹𑐏𑐵 | भुलूखा | bʱuluːkʰa | (bhulūkhā) | Noun | 1. owl
𑐨𑑁 | भौ | bʱəu | (bhau) | Noun | 1. cat
𑐨𑑂𑐰𑑄 | भ्वं | bʱwɔ̃ː | (bhwaṃ) | Noun | 1. paper
𑐨𑑂𑐰𑐫𑑂 | भ्वय् | bʱwɔɛː | (bhwaê) | Noun | 1. feast
𑐩𑐔𑐵 | मचा | mət͡ɕa | (macā) | Noun | 1. child
𑐩𑐟𑐶𑐣𑐵 | मतिना | mətina | (matinā) | Noun | 1. love
𑐩𑐥𑐄 | मपउ | məpəu | (mapau) | Adjective | 1. (Dolakha) sick, ill
𑐩𑐵𑐎𑑅𑐢𑐸𑑃 | माकःधुँ | makəːdʱũ | (māka:dhũ) | Noun | 1. bear
𑐩𑐶𑐏𑐵 | मिखा | mikʰa | (mikhā) | Noun | 1. eye
𑐩𑐶𑐖𑑄𑐩𑐔𑐵 | मिजंमचा | mid͡ʑə̃ːmət͡ɕa | (mijaṃmacā) | Noun | 1. boy, male child
𑐩𑐶𑐥𑐸𑐔𑑅 | मिपुचः | miput͡ɕəː | (mipuca:) | Noun | 1. society
𑐩𑐶𑐳𑐵𑐩𑐔𑐵 | मिसामचा | misamət͡ɕa | (misāmacā) | Noun | 1. girl, female child
𑐩𑐸𑐐𑑅 | मुगः | muɡəː | (muga:) | Noun | 1. hammer
𑐩𑐾𑐫𑑂 | मेय् | meɛː | (meê) | Noun | 1. water_buffalo
𑐩𑑂𑐫𑐾 | म्ये | mje | (mye) | Noun | 2. music
𑐩𑑂𑐰𑐵𑐫𑑂 | म्वाय् | mwæː | (mwæ) | Noun | 1. banana
𑐪𑐎𑐸𑐔𑐵 | म्हकुचा | mʱəkut͡ɕa | (mhakucā) | Noun | 1. organ
𑐪𑐐𑑅𑐳 | म्हगःस | mʱəɡəːsə | (mhaga:sa) | Noun | 1. dream
𑐪𑐵𑐳𑐸 | म्हासु | mʱasu | (mhāsu) | Noun | 1. yellow
𑐪𑐸𑐟𑐸 | म्हुतु | mʱutu | (mhutu) | Noun | 1. mouth
𑐪𑐸𑐟𑐸𑐳𑐶 | म्हुतुसि | mʱutusi | (mhutusi) | Noun | 1. lip
𑐪𑑂𑐫𑐵𑐫𑑂 | म्ह्याय् | mʱjæː | (mhyæ) | Noun | 1. daughter
𑐪𑑂𑐫𑑂‌𑐏𑐵 | म्ह्य्‌खा | mʱɛːkʰa | (mhêkhā) | Noun | 1. peacock
𑐫𑐵𑐳𑐸 | यासु | jasu | (yāsu) | Pronoun | 1. Devanagari_script form of yāsu, which is locative plural of या (yā,
𑐫𑐾𑑃 | येँ | jẽ | (yẽ) | _ | 1. Kathmandu
𑐫𑐾𑐟𑑂 | येत् | jet | (yet) | Verb | 1. to do
𑐮𑑃 | लँ | lə̃ | (lã) | Noun | 1. road
𑐮𑑅 | लः | ləː | (la:) | Noun | 1. water
𑐮𑐂𑑃𑐔𑐵 | लइँचा | lə̃it͡ɕa | (la͠icā) | Noun | 1. henna, mehndi (Lawsonia_inermis) (clarification of this definition is
𑐮𑑅𑐏𑑅 | लःखः | ləːkʰəː | (la:kha:) | Noun | 1. ship
𑐮𑐐𑐵𑐣𑐷 | लगानी | ləɡaniː | (lagānī) | Noun | 1. investment
𑐮𑐑𑑂𑐰𑐵𑐟𑐸 | लघ्वातु | ləɡʱwatu | (laghwātu) | Noun | 1. lithium
𑐮𑐴𑐣𑐵 | लहना | ləhəna | (lahanā) | Noun | 1. civilization
𑐮𑐵𑐎𑐵𑑄 | लाकां | lakãː | (lākāṃ) | Noun | 1. shoe
𑐮𑐵𑐫𑐾𑐮𑐵𑐩𑐵 | लायेलामा | lajelama | (lāyelāmā) | Noun | 1. rainbow
𑐮𑐸𑑃 | लुँ | lũ | (lũ) | Noun | 1. gold
𑐮𑐸𑐩𑐣𑑂𑐟𑐶 | लुमन्ति | lumənti | (lumanti) | Noun | 1. memory
𑐮𑐸𑐳𑐵𑑅 | लुसाः | lusaː | (lusā:) | Noun | 1. telescope
𑐮𑐾𑐟𑐵𑐃𑐐𑐸 | लेताईगु | letaiːɡu | (letāīgu) | Noun | 1. happiness
𑐮𑑂𑐫𑐵𑑅 | ल्याः | ljaː | (lyā:) | Noun | 1. number
𑐮𑑂𑐫𑐵𑑅𑐖𑑂𑐫𑐵 | ल्याःज्या | ljaːd͡ʑja | (lyā:jyā) | Noun | 1. mathematics
𑐮𑑂𑐰𑐴𑑄 | ल्वहं | lwɔhə̃ː | (lwahaṃ) | Noun | 1. rock
𑐮𑑂𑐰𑐴𑑄𑐔𑐵 | ल्वहंचा | lwɔhə̃ːt͡ɕa | (lwahaṃcā) | Noun | 1. gravel
𑐮𑑂𑐰𑐵𑐨𑑅 | ल्वाभः | lwabʱəː | (lwābha:) | Noun | 1. weapon
𑐯𑐵𑑅 | ल्हाः | lʱaː | (lhā:) | Noun | 1. arm
𑐯𑑂𑐰𑐎𑐦𑐵𑐎 | ल्ह्वकफाक | lʱwɔkəpʰakə | (lhwakaphāka) | Noun | 1. cholera
𑐰𑐔𑐸 | वचु | wɔt͡ɕu | (wacu) | Noun | 1. blue
𑐰𑐴𑑅 | वहः | wɔhəː | (waha:) | Noun | 1. silver
𑐰𑐵𑑄𑐐𑐸 | वांगु | wãːɡu | (wāṃgu) | Noun | 1. green
𑐰𑐵𑐳𑐵 | वासा | wasa | (wāsā) | Noun | 2. nominative/vocative plural (vāsa)
𑐳𑑃 | सँ | sə̃ | (sã) | Noun | 1. hair (of the head)
𑐳𑑄𑐎𑐶𑐥𑐵 | संकिपा | sə̃ːkipa | (saṃkipā) | Noun | 2. cinema
𑐳𑑄𑐎𑑂𑐬𑐵𑐩𑐎_𑐮𑑂𑐰𑐫𑑂 | संक्रामक ल्वय् | sə̃ːkɾaməkə lwɔɛː | (saṃkrāmaka lwaê) | Noun | 1. infectious_disease
𑐳𑑃𑐎𑑂𑐰𑑅 | सँक्वः | sə̃kwɔː | (sãkwa:) | Noun | 1. raven
𑐳𑐏𑑂𑐰𑐵𑑅𑐮𑑂𑐰𑐴𑑄 | सख्वाःल्वहं | səkʰwaːlwɔhə̃ː | (sakhwā:lwahaṃ) | Noun | 1. limestone
𑐳𑐣𑑂𑐟𑑂𑐬𑐵𑐳𑐶 | सन्त्रासि | səntɾasi | (santrāsi) | Noun | 1. orange (fruit)
𑐳𑐦𑐹 | सफू | səpʰuː | (saphū) | Noun | 1. book
𑐳𑐦𑐹𑐢𑐸𑐎𑐹 | सफूधुकू | səpʰuːdʱukuː | (saphūdhukū) | Noun | 1. library
𑐳𑐩𑐵𑑅𑐖𑑂𑐰𑐮𑑄 | समाःज्वलं | səmaːd͡ʑwɔlə̃ː | (samā:jwalaṃ) | Noun | 1. makeup, cosmetics
𑐳𑐮_𑐧𑑂𑐰𑐵𑐎𑐶𑐐𑐸 | सल ब्वाकिगु | sələ bwakiɡu | (sala bwākigu) | Noun | 1. horse_racing
𑐳𑐮𑐵𑐂 | सलाइ | səlai | (salāi) | Noun | 1. match (to strike fire with)
𑐳𑐶 | सि | si | (si) | Noun | 1. fruit
𑐳𑐶𑑃 | सिँ | sĩ | (sĩ) | Noun | 1. wood
𑐳𑐶𑐏_𑐢𑐬𑑂𑐩 | सिख धर्म | sikʰə dʱəɾmə | (sikha dharma) | _ | 1. Sikhism; the Sikh religion
𑐳𑐶𑐣𑑅𑐳𑐶𑑃 | सिनःसिँ | sinəːsĩ | (sina:sĩ) | Noun | 1. sandalwood
𑐳𑐶𑐤𑑅 | सिन्हः | sinʱəː | (sinha:) | Noun | 1. tilak
𑐳𑐶𑐫𑐸 | सियु | siju | (siyu) | Noun | 1. brown
𑐳𑐷 | सी | siː | (sī) | Noun | 1. wax
𑐳𑐷𑐖𑑅 | सीजः | siːd͡ʑəː | (sīja:) | Noun | 1. copper
𑐳𑐸𑐥𑐵𑑃𑐫𑑂 | सुपाँय् | supæ̃ː | (supæ̃) | Noun | 1. cloud
𑐳𑐾𑑄 | सें | sẽ | (seṃ) | Noun | 1. liver
𑐳𑑂𑐫𑐵𑐫𑐾 | स्याये | sjaje | (syāye) | Verb | 1. to kill
𑐳𑑂𑐰𑑃 | स्वँ | swɔ̃ | (swã) | Noun | 1. lung
𑐳𑑂𑐰𑐎𑐸𑑄 | स्वकुं | swɔkũː | (swakuṃ) | Noun | 1. triangle
𑐳𑑂𑐰𑐵𑑄 | स्वां | swãː | (swāṃ) | Noun | 1. flower
𑐳𑑂𑐰𑐵𑐣𑐾 | स्वाने | swane | (swāne) | Noun | 1. stairs
𑐳𑑂𑐰𑐵𑑄𑐩𑐵 | स्वांमा | swãːma | (swāṃmā) | Noun | 1. shrub
𑐴𑑃 | हँ | hə̃ | (hã) | Noun | 1. chisel
𑐴𑐟𑐵𑑅 | हताः | hətaː | (hatā:) | Noun | 1. war
𑐴𑐠𑑄 | हथं | hətʰə̃ː | (hathaṃ) | Noun | 1. soapberry
𑐴𑐮𑐶𑐩 | हलिम | həlimə | (halima) | Noun | 1. world
𑐴𑐵𑐎𑐸 | हाकु | haku | (hāku) | Noun | 1. black
𑐴𑐵𑐳𑐵 | हासा | hasa | (hāsā) | Noun | 1. nanglo, a flat woven tray made of bamboo
𑐴𑐶𑑃𑐎𑐶𑑄 | हिँकिं | hĩkĩː | (hĩkiṃ) | Noun | 1. screw
𑐴𑐶𑐟𑐶 | हिति | hiti | (hiti) | Noun | 1. faucet, tap
𑐴𑑂𑐫𑐵𑑄𑐐𑐸 | ह्यांगु | hjãːɡu | (hyāṃgu) | Noun | 1. red
𑐴𑑂𑐰𑐖𑑂𑐫𑐵 | ह्वज्या | hwɔd͡ʑja | (hwajyā) | Noun | 1. irrigation
𑐎𑐮 | कल | kələ | (kala) | Noun | 1. machine, device
